..................................................
.....................................###..........
...............................##......####.......
.............................#............###.....
............................................##....
..........................#..................##...
...............................#######........##..
....#....#..................####.....###.......#..
.....#..##........####....###..........###.....##.
.....#.#.......#..###..####.............###.....#.
....####.....##..........##......#####....##....#.
.....#.#....#............###.........###...##...#.
.....#..#..#........#.......#####.......##..###.##
..####..#.......#........#..##..###......##...###.
..###....#.....###.......#...#.....##......#......
....###........##............##.....##......#.....
......###...####....##...#...##......#......##....
........#....##.....##...#...###......#......##...
........#..#............#...####......##......##..
............#..........#....####.......#......##..
.............#...........@..####.......#.......#..
........#......##...####...#####........#......##.
........#...#..########....#####........#......##.
........#....########......######.......#.......#.
........#....#######......#####..#......##......#.
........##...#..###.......#####...#.....##......#.
........##......#........####.#...##.....#......#.
.........##..###.......#####..##..##.....#......#.
.........###..#.......######..##..##.....##.....#.
..........####..###########..#....##......#....##.
...........###############..#######.......##...##.
............############...#..###..........#####..
.............##....##....###................###...
..............###.....#####.###...................
...............########.##....##..................
.............#.......##.#......##.................
.....................##.#.......##................
...........#........##..##.......##...............
...........##########....#.......##...............
............#######.......##......#...............
...........................###....#...............
.............................######...............
