.............
......#......
....#####...
...##...##...
..##.#.#.##..
.##...#...##.
##....@....##
.##..###..##.
..##.....##..
...##...##...
....#####....
..#########..